A	工单编号
B	关联主单号
C	工单状态
D	客户电话
E	重复次数
F	紧急程度
G	工单来源
H	工单类型
I	录音文件编号
J	受理号码归属地
K	客户名称
L	联系电话
M	联系人
N	联系地址
O	受理内容
P	受理时间
Q	受理人工号
R	最终服务类别
S	当前环节
T	处理次数
U	全程超时时间
V	客户品牌
W	流程名称
X	当前单位接单时间
Y	当前单位工单超时时长
Z	归档工号
AA	归档时间
AB	归档班组
AC	派外系统流水号
AD	工单总历时时长（小时）
AE	工单整体超时时长（小时）
AF	工单整体超时天数（天）
AG	工单流转次数
AH	第一责任班组
AI	第二责任班组
AJ	受理班组
AK	派送班组
AL	当前班组
AM	是否加入黑名单
AN	首次发协查时间
AO	最终产品类型
AP	局向
AQ	战略分群
AR	统计属性
AS	机楼
AT	服务等级
A	归档内容
AV	第一接单班组
AW	环节编号
AX	环节名称
AY	处理人
AZ	环节处理班组
BA	环节开始时间
BB	环节结束时间
BC	环节超时时间
BD	环节处理时长
BE	环节实际处理时长
BF	环节超时时长
BG	环节处理内容
BH	超时原因
BI	环节挂起次数
BJ	挂起总历时
BK	本环节处理是否合格
BL	质量评价意见
BM	产品类型
BN	服务类别
BO	环节操作名称
BP	一级
BQ	二级
BR	三级
BS	四级
BT	活动备注
BU	监控
BV	归档日
